@.^^**^^.*
.*^*^**.~~
..*^^*^~**
^^^^^.^^*~
.~.^^.....
~^.~*^.*.*
.^^...*^.~
***~*^*~**
.....*~^~^
.*.*.*^^X~