@~~~~~~~~~
*~~~~~~~~~
^~~~~~~~~~
~.~~~~~~~~
*^~~~~~~~~
.^**.~~~~~
.~~^*~~~~~
~.^.*~~~~~
~~^~.^..^~
~~~~~^~*~X