@^^~~*~~*~
*.*^.^**.*
^.*.*^~^*.
*..*.*^.^^
^**~.*.^~.
**.~.*^.**
*.^.*.^*.~
*^~.**^^^^
.~.**...^*
^**^~^...X