@**~~*^~^.
.*^^^*~^*~
.*~~~~~^..
~~~.*~~*~^
*~**.***.~
~**.~~.~~.
...^**.~^*
*^*~^*..^*
^^..~^^~*^
^**^~**.~X